11111111111111111111
11111111111111111111
10000000000000000001
11111111111111111111
1100C000001111111111
1X0000P0000E0000X001
111C00000000000C0001
100001111100X0000111
10000000000C11111111
1CC00000111000001111
1CC00000111111101111
1000CC11110000C11111
11110000000001111111
1100011110000000C011
111110X000111111C111
11111000000001111111
1000000000000C000011
11111110CC11000X0111
1000CC00000000000011
11111111111111111111