1111111111111111111
1000001111111000001
1000000000000000001	
1001111000000000001
1000000001100000001
10P00000000000C0001
1000000100000010001
1000000000000010001
10E000000C011110001
1000000000000000001
1000000000C000C0001
1111111111111111111