11111111111111111111
111000CC001100010101
1100E0P0000C00000001
11100111111111111111
11111111111100000001
11111111111111111111
11111111111111111111