11111111111111
111CC111111C11
10000000000001
111111C1111111
10000000011101
10000000C00001
100CCCC0PEC001
11111111111111