1111111
110EPC1
1000001
1111111