11111111111111
11111111111111
10000000000001
11111111111111
10000000000001
11111111111111
10000000PEC001
11111111111111